board = [
  [0, 0, 0, 5, 7, 3, 0, 0, 2],
  [0, 0, 7, 0, 0, 0, 0, 0, 1],
  [0, 0, 0, 2, 9, 1, 3, 6, 0],
  [0, 6, 0, 4, 2, 5, 1, 8, 0],
  [0, 1, 0, 0, 0, 0, 0, 5, 0],
  [0, 8, 4, 1, 6, 9, 0, 2, 0],
  [0, 4, 1, 6, 5, 7, 0, 0, 0],
  [6, 0, 0, 0, 0, 0, 4, 0, 0],
  [8, 0, 0, 9, 1, 4, 0, 0, 0]
]